1111111111111111111111111111111111111111111111111
1000000000001000001000000000000000000000100000001
1011111110101010111011111111101111111110101111101
1010100000101010000010100000001000000000101000101
1010101111111011111110101111111011111111101010101
1000101000000010000000100010000000001000001010101
1111101011111110111110111011111111101011101011101
1000100000100010000010001000001000101000101000101
1010111110101011111011101111101011101110101110101
1010000010001000000010100010101000101000100010001
1011111011111111111110111010101010101110111010111
1010001000000000100000001000101010000010001010101
1011101111101110111011101110101111111011111010101
1000100010001010001010001000101000001000000010101
1110101010111011101010111011101011101011111110101
1000101010001000101010100010100010101010001000101
1011101111101110101110101110111110101110101011101
1010001000000010100010100000000000101000101010001
1011101011111110111010101111111110101011101011101
1010001010001000100010001000001000101010001000001
1010111010111011101111111011101111101010111111101
1010000000100010101000100010100000100010000000101
1011101111101110101010101110111110101111101110101
1000100010001000101010101000000010101000100010101
1010111010111010101010101011101110111010111110101
1010001010001010000010001010101000100010100010101
1111101011101111101111111010101011101110101010101
1000101000100000101000001010001000100010001000101
1010101111111110111011101011111110111011111111101
1010001000000010001010101010000010001010001000001
1011111010111111101010101010101011101010111011111
1010000010000000100010001000101000100010100010001
1010111111111110111110111011101110111110101110101
1010001000000000000010100010001000100000100010101
1011101011111011111110101110111011111010111010101
1000001010000010000010101010100000001010100010101
1111111011111110111010101010111111101110101110101
1010001000000000101010100010000010000000101000101
1010101111111111101010111111111010111110101010111
1000100000000000001000100000000010100010101010001
1111111011101111101111101111111111101011101011101
1000001000100010101000100000000000001010001010001
1011101111111010101010101111111111111010111110111
1010101000000010001010001000000000101010100010001
1010101011111011111011111011101110101010101011101
1010000010000010001010001010001000101000101000001
1011111111111110101010101110111011101111101111101
1000000000000000100000100000100000000000001000001
1111111111111111111111111111111111111111111111111