111111111111111111111
1P00100000100000000C1
101010111011111110101
101010001000100000101
1F1111101110101111101
101000001000100010001
101011111011101010111
101000101000101010101
101110101111111010101
101000101000000010001
101011101010111111101
101000100010101000001
101110111110101011111
100010000000101000001
101111111111101111101
101000000000000010001
101011111110111010111
101000000010001010101
101111111011101110101
1000000000001000000F1
111111111111111111111