1111111111111111111111111111111111111111111111111
1000100010001000000000001000000000100000000000101
1010101010101111111110101110111110101111111110101
1010101000100000000000100010100010100010000000101
1110101110111111111111111010101010111011101111101
1000100010100000100000001000101010001000100010001
1011111011101110101111101111101111101110111011101
1000001010001010100000100010000000100000101000101
1010111010111010111110111110111110111111101110101
1010001000100010000010001000100010000000000010101
1011101111101111111010101011101011111011111110101
1010001000101000000010100010001010001000000010101
1010101010101011111110111110111011101111111010101
1010100010101010100010100000100000000010100010001
1110111110101010101010101111111111111010101111101
1000100000101010101000101000100010001010100000001
1011111110101010101111101010101010101010111111111
1010000010001010100010001010001000101000000010001
1010111011111010111010111011111111101111111010101
1010101000001010000010000010000000100010000000101
1010101111101110111111111010111110111011111111111
1010000010001010001000001010100010001000000000001
1011111010101011101011101011101010101111111111101
1000000010101000100010101000001000101000100000101
1011111010101011111110101011111111101010101010101
1010001010101010000000001010000010101010101010101
1110101110101010111111111010111010101010111010101
1000100000101010000000100010101010000010001010101
1011111111101011111110111110101011111111101011101
1000100000000000001010000000101010000010100010001
1110101111111111101011111111101010111010111010111
1000101000001010001000001000001000100010000010001
1011111011101010111010101110101111101111111011101
1010001000101010001010100000100010001000001010001
1010101110101011101110101111111010111011101110101
1000100010101000000000101000001010100010100000101
1011101110101111111111101011101110101110111111101
1000100000100000001000101010101000101000100000101
1110111111111111101010101010101011101010101011101
1010100000000000100010101000100010001010001000001
1010101111111011111110111110111110111011111111111
1010100000001000100000100000100010101010000000001
1010111111111010101111101111101010101010101111101
1000100000001010100000001000001000101010101000101
1011101111101110111111111011111111101011101010101
1010001000100010001000001010001000001000100010101
1010111010111010101110101010101010111110111110101
1000100010000000100000100010100010000000000000101
1111111111111111111111111111111111111111111111111