1111111111111111111111111111111111111111111111111
1000001000100010001000000010000000100000000010001
1011101010101010101011111010111110101111101010101
1010000010001000101010001010100010000000101010101
1011111111111111101010111011101011111111101010101
1000000000000010100010001000001010000000001000101
1111111111111010111111101111111010111111111111101
1000001000000010000000000000001000100000100000101
1011101011111111101111111110111111111011101010101
1010100010001000001000000010100000000010001010101
1010111110101011111011111011101110111110111011101
1010001000100010001010001010001000100000101010001
1010101011111110101011101010111010101111101010111
1010100010000000100000001000100010100010001010001
1010111110111111111111111111101111111010101011101
1010100010000010000000001000101000001010101000001
1010101011111010111111101010101010111010101111111
1010001000001010000000100010001010000010100000101
1110111110111011111110111111111011111110111110101
1010000010001010000010000000001000100000101000101
1011101111101010111111111111101110111011101011101
1000001000001010100000000000100010000010001000001
1011111011111010101110101111101011111110101111101
1000001000100010000010101000001000100010100010001
1111101110101111111110101011111110101010111010111
1000100010101000100000101000001010101010101010101
1010101110101010101111101111101010111010101010101
1010101000100010001010001000101000000010001000101
1011101011111111111010111011101011111111101111101
1000001000000000001000100010001010000000001000001
1011111111101110111011101010111110111111111011101
1010000000100010100010001010100000100000100010001
1010101111101011101111101110101111101111101110101
1000101000101000100000001000100010000000001000101
1111111010111110111110111010111011111111111011101
1000001010000000100010100010001000001000000010001
1011101011111011101010101111101111101011111110111
1000100010001010001010100000101000101010001010001
1110111111101010111010111110101011101010101011101
1000100000100010101000100010100010001010101000101
1011101110111010101111101110111010111010101010101
1000101010001010001010000010100010100010100010101
1010101011101111101010111010111010101110101111101
1010100000100000101000001010001010101000101000101
1110111110111110101111111011101110101010111010101
1000001000101000101000000010100010001010000010001
1011111011101011101011111010111011111011111111111
1000000000001000000010000000001000000000000000001
1111111111111111111111111111111111111111111111111