1111111111111111111111111111111111111111111111111
1000000010000010001000000000000010000000000000101
1011101110101010101010111111111110111111111010101
1010001000101000101010100000000010000000101010101
1011111011101111101110101111111011111110101010101
1000000000101000100000100010000000000010101010001
1011111111101011101111111010111011111110101011101
1000100010001000001000100010100010000000001010001
1111101010111011111010101110111110111111111011111
1000001010100010000010001010100010100000100010001
1011111010111110111110111010101010101110101110101
1000001010000000100010000010001010001010100000101
1111101011101111101011111111111011111010111111101
1000101000101000001010001000001000000000001000001
1011101111101011111010101011101011111111111011101
1000100000101000001000100010001000100010000010101
1110111110111111101011111110111110111010111110101
1000000010001000001010001000100010000010000010001
1011111011101011111110101011101011111111111010111
1010000000101000000000101010001010000000000010101
1011111111101011111111101010101010111111111110101
1010000000001000001000101010101010100000100000101
1010111111111111111010101011101010111011101111101
1010000000001000000010101000001000100010001000101
1011111111101011111110101110111111101110111010101
1000100000101010000000101000100000101000100010001
1110101011101010111111101111101110101011111011111
1000101000100010100000100000000010101000001000001
1011101110111110111110101111111010101111101111101
1010001010000010000010001010001010100000100000001
1010111010111111111011101010101110111110111111101
1000100010100000001000100010100010100010100000101
1011101110101111101110111010111010101010101011101
1010100010101000101000100010101010101010001000001
1010101010101110101011101110101010101011111110111
1010001010001000100010001000100010001000000010101
1011111011111011111111111011101111101111111010101
1010000000100000000000100010000000100010000010101
1010111110101110111110101111111110111110111110101
1010001010100010101000100010001000100000100010101
1011101010111010101011111010101011101111101010101
1010001000100010100010001010101000001010001010001
1010111011111010101110101010101111111010101111101
1010100010001010101000101010100010100000101000001
1010101110101010101110101010111010101111101011111
1010101000101010100010101000001010101000100010001
1010101011101110111010101111111010101110111111101
1000100010000000100000100000000010000000000000001
1111111111111111111111111111111111111111111111111