1111111111111111111111111111111111111111111111111
1010000000001000001000000000001000000000000000001
1010111011101011101111111011101110111111111111101
1010101000101010100010000010000000101000000000101
1010101110101010111010101111111111101011111110101
1000001000101010001000101000100010000010001010001
1111111011101010101111101010101110111110101011111
1000000010101010100000001010100000100000101000101
1011111110101011111111111010101111101111101010101
1000000010001000100000000010101000101000100010001
1011111011111110101111111110101010101011111111101
1000001010000010001000100000100010001000000010001
1111101010101011111110101111111011111011101110111
1010001000101000000000100000001010001000100000101
1010111111101111111110111111101110101110111111101
1010100010001000100010001000100000100010000000001
1010101010111010101111101011111111111011111111101
1000101010000010101000100010000010100010001000001
1011111011111110101010111010101010101110101110111
1010000010000010100010000010101010100000100010101
1010101011111010111011111110101010111111111010101
1010101000000010001000001000101000001010000010101
1010101111111011101111101011101111101010111110101
1010101000001000100000101000101000101010000010001
1011101011101110111110111011101010101011111111101
1000101000100010100010000010001010101000100010001
1110101010111110101111111110111011101011101010111
1010101010100010100000001000100000100010001010101
1010101110101010111110101011111010101110111010101
1010100010001000000000101010001010001000100010001
1010101011111111111111101010101110111011101111101
1010101000100000100000101010100010101010100000001
1010111110101110101011101010111010101010111111111
1010100010001000101010001010101010001010000000001
1010101010111011101010111010101011111010111111101
1010001010100010101010101000101000001010100000101
1011111010101110101010101111101111101011101110101
1000100010101000101000100000001010001000001010101
1010101110101011101111101111101010111111111010101
1010101000101000100000101000001010000000001000101
1010101111101110111110101110111011111111101011101
1010100000001000100000100010100000000000100010001
1011111111111011101111111010111111111010111111101
1000000000001000001000100010000000001010001000001
1011111011111011111010101111111111101010101110101
1000001010000010001010101000100000001010100000101
1111101010111110101010101010101111111110111111101
1000001000000000100010001010000000000000100000001
1111111111111111111111111111111111111111111111111