1111111111111111111111111111111111111111111111111
1000000010000010001000100010000000000010000000001
1011111010111010111010101010111111101011101111101
1010001000101010000010101000100000101000101010001
1010101111101011111110101111111110101110101010111
1010100010001000000010100000100000101010101010001
1010111010111111111010111110101111101010101011101
1010001010001000000010000010100010001010100010001
1011101010101011111111111010111010111010111010101
1000001010100000000000000010000010100010101010101
1011111011111111111111111011111010101010101010101
1000101000001000000000001010000010101010100010101
1110101111101111101111111010111110101110111110101
1000101000001000100000000010100010100000000000101
1011101011101010111111111110101010111111111111101
1000001010001010100000000000101010100000100000101
1111101010111010101111111111111010101110101111101
1000001010001010100000100000001010001010100000001
1011111011111010111110111110101011111010101111101
1000001000000010000000100000101010000010101000101
1111101111111111111111101111101010111010111010111
1000100010000000000000101000101000100010000010001
1010111010111011111110101010101011101011111111101
1010100010100010000010001010001010001000000010001
1011101110101110101111111011111110111111111110101
1010001010100010100000100000001000100000000000101
1010111010111011111011101111101010101111111111101
1010001000001000001000101000100010101000100000101
1011101111111110101010101010111110101010101110101
1000100000100010101010001010001000101010100010001
1010111110101010101011111011101011101110111011111
1010100010001010101010000010001010001000001000101
1110101011111011101010111110111010111010111110101
1000101000100010001010000010100010001010100000001
1011101010101110111111111010111111101011101111111
1000001010101000000000100010000000101000100010001
1011111011101111111011101111101011101110111010101
1000001010001000001000001000101000100010100010101
1111101010111011101111111010111110111010101110101
1010001010001010001000000010100010001010000010101
1010111011101010111011111110101011101011111110101
1010101000001010100000100010001000101000001000101
1010101111111010101110101011111110101111101111101
1010000000001010101010101000001010001000100000101
1011111111101010101010101111101011101011101111101
1010000000101010100010001000001000101010001000001
1010111110101010111111111011111011101010111011111
1000000010000010000000000010000000000010000000001
1111111111111111111111111111111111111111111111111